cancer	wt
ALIHHNTYL	ALIHHNTHL
ALSPVIPHI	ALSPVIPYI
ALYGFVPVL	ALYGSVPVL
AMFWSVPTV	AMFRSVPTV
ASNASSAAK	ASNAPSAAK
AVGSYVYSV	AVGSHVYSV
AYHSIEWAI	AYHPIEWAI
CILGKLFTK 	CILGELFTK 
CLNEYHLFL 	CLNEYHLFF
CYMEAVALV	CYMEALALV
DANSFLQSV	DANPFLQSV
EHEGSGPEL	EREGSGPEL
ELLVRINRL	ELLFRINRL
FFFFKTTAL	SFFFKTTAL
FIYKSDFVK	FIYKSDLVK
FLIYLDVSV	FLTYLDVSV
FLMASISSF	FLMASISSS
FLSQRVAFL	FLRQRVAFL
FLYNLLTRV 	FLYNPLTRV 
FMPDFDLHL	SMPDFDLHL
FQPSFSHLV	FQPSFPHLV
FQSNFQEFY	CVFQSNFQEL
FQYHSLNVI	FQYHSLDVI
FSADIFFFF	FSADISFFF
GLFGDIYLA 	GSFGDIYLA 
GLGPGFSSY	GLGPGFSGY
GLLDEDFYA	GPLDEDFYA
GSDIMSFVI	GSDIMSFVV
HLYASLSRV	HPYASLSRV
HVKITDFGR	HVKITDFGL
ILAALFLGL	IWAALFLGL
ILTGLNYEV	ILTGLNYEA
IPLSDNTIF	IPLSDNTIS
KLMNIQQKL 	KLMNIQQQL 
KLSHQLVLL	KLSHQPVLL
KLYEEPLLK	KLYEEPLSK
KMIGNHLWV 	EMIGNHLWV 
KTLTSVFQK 	ETLTSVFQK 
KVDPIGHVY	EVDPIGHVY
LIIPFIHLI	LIIPYIHLI
LLDSLPMDV	LLDSLPMDA
LLFGMPPCL	LLFGMSPCL
LLGVKLFGV	LLGVKLSGV
LLLMSTLGI	LSLMSTLGI
LMASISSFL	LMASISSSL
LPRQYWEAL	LPRQYWEEL
MGKSTHTSM	MGNSTHTSM
MLFSHGLVK	MLFSRGLVK
MLGEQLFPL 	MLGERLFPL 
NLNCCSVPV	NLNRCSVPV
QLCDVMFYL 	QLRDVMFYL 
QLSCISTYV 	QLSCTSTYV 
RPQGQRPAL	RPQGQRPAP
RVAGSMSSL	RAAGSMSSL
RVSTLRVSL	RVSTLRVSP
RVWDIVPTL	RVRDIVPTL
SVQIISCQY	SVQIIPCQY
SYMIMEIEL	SSMIMEIEL
TLWCSPIKV	TPWCSPIKV
TPTVPSSSF	TPTVPSGSF
TYLPSAWNF	TYLPSAWNS
VLFEDAVAY	VLFEDAVAH
VMKHLLSPL	VMQHLLSPL
VTEKLQPTY	VTEKLQLTY
VVMSWAPPV	VVLSWAPPV
VYQYTFPDF	VYQYTSPDF 
WLIDMKSLV	WLIDMESLV
YLSNIIPAL 	YLSKIIPAL 
YLYDRLLRV 	YLYDRLLRI 
YMDGTMSQV	YMNGTMSQV
YPVIFKSIM	YPVISKSIM
YTDFHCQYV 	YTDFPCQYV 
YYSKNLNSF	YYSKNLNSS
