Cancer		WT
SIYVYKVMK	SIYVYKVLK
GLLDAITYL	GLLDAVTYL
GFTAIFLTY	GFTAIVLTY
AMLDTVIFK	AMLDTVVFK
NLVHYLTEV	NLFHYLTEV
GLFSAKIFL	GLFSAKLFL
NYLSPYQFL	NYLAPYQFL
RLYEGLDWL	GLYEGLDWL
RLLSSVFKL	SLLSSVFKL
RVVDIFQTV	GVVDIFQTV
SLVNIYSQL	SLVDIYSQL
LILDPVLLV	LISDPVLLV
SLAWDVLAA	SLAWDVPAA
KLFKFMHET	KLFEFMHET
SPVSFIAAY	SPVSFIATY
RLNKVFSEL	RLNKVISEL
TYPDVSNSI	TYPDVNNSI
LLYEKSISL	LLYEKGISL
FLLDKAVLI	FLLDKALLI
FLLIFFFLL	FLFIFFFLL
YVLDLLVQL	SVLDLLVQL
KLMDQLEVL	KLMDQLEAL
ILWDTLLWL	ILWDTLLRL
ALHDILTAI	ALHDILTEI
KTLTLPFYW	KTLTLPFSW
NYLGKYWAI	TYLGKYWAI
LPEKGFRSY	LPVKGFRSY
SLFGGFVKL	SLFGGSVKL
VLIKDVQEI	VLMKDVQEI
VLKEIVEHV	VLKEIVERV
RYQKSTKLL	RYQKSTELL
ILLAELQQL	ILLAELEQL
LLWNNYFHL	QLWNNYFHL
FPMSLVTSV	FPMSPVTSV
LLSVVLPSV	LLSAVLPSV
TLKDTITNV	TLKDTITSV
GLAKFQENV	GLAEFQENV
VLYPNVVQV	ALYPNVVQV
ELSDFLIYL	ELSDVLIYL
SPVESTTSI	SPVKSTTSI
GLRGWAFTL	GLHGWAFTL
GLMQQKIYI	GLMQEKIYI
LLAELPASL	LLAELPASV
FLMDFINQV	FLMDFIHQV
ALIGHLQTL	SLIGHLQTL
ITTYVLYTI	ITTDVLYTI
KLVQLPYTV	KLVELPYTV
KLAEALSSL	KLAEALPSL
ILFHYRITV	RLFHYRITV
QLVHFQWKL	QLVDFQWKL
IIWSHLELL	ILWSHLELL
IILDILEYI	RILDILEYI
KLMELYECL	KLMELYERL
ALLECLTVV	ALLEGLTVV
TLMAEMHAV	TLMAEMHVV
PPLEDLASF	QPLEDLASF
QIFSAFLLK	QIFSEFLLK
AETVVQLFI	AETAVQLFI
IPHIHKFLI	IPHIHKSLI
KLQEALTQL	KLQEALSQL
EADPTGHPY	EADPTGHSY
TLNDREFQL	TLNDREYQL
VLITGLHAV	VLLTGLHAV
QVKMWFQNR	QVKTWFQNR
ILIGDTIKI	ILIGETIKI
LLVRNSFEV	LLGRNSFEV
TLSQDIPEI	ALSQDIPEI
SLEIRTLLY	SLEIRALLY
KYTLPPHHI	KYTPPPHHI
SFIHYVFRL	SYIHYVFRL
VVMGALVAL	VVMGTLVAL
FLYLFPLAL	FLYPFPLAL
RYFDSTFTF	RYSDSTFTF
KMDEILYSI	KMDEVLYSI
TLTTQFLVY	TLITQFLVY
FLLNVVMDL	SLLNVVMDL
LLSIKTVGV	LLPIKTVGV
AIVQSLPSV	AIVRSLPSV
KISASALLK	KISALALLK
RFISYTEEF	RFIPYTEEF
IPATVKLTY	IPAAVKLTY
ALQTIHLFL	ALQTIQLFL
ILYSIAEKV	VLYSIAEKV
LPAEEFNEL	LPVEEFNEL
RTYNLYITY	RTYDLYITY
RLLDYMATV	RLLDYVATV
GILENIPRV	GLLENIPRV
STYSGLFCV	YTYSGLFCV
LYGPDTPFI	LYGPDTPII
RLLDGTFKL	RLLDGAFKL
HISPNAIYK	HISPNAIFK
ALLFAVTRL	ALLSAVTRL
RYEGFFSRW	RYEGFFSLW
QLSHVLLYL	QLSPVLLYL
YPIGRDGKL	SPIGRDGKL
ETFLMRLTV	ETFVMRLTV
SLAKLIQAL	SLAELIQAL
HPYLFPMAA	HPYLFPVAA
VLLENKILL	VLLESKILL
LIQDKQFEL	LLQDKQFEL
FPLASLLAL	FPLAPLLAL
LVDQWLDSY	LVDEWLDSY
VLANVILLK	VLADVILLK
DSDGPFFLY	DSDGSFFLY
LYTEAIKLF	LYTEAIKFF
FIISAVVGI	SIISAVVGI
KLYPLPLAR	KLYPLPSAR
AMLERQFTA	AMLERQFTV
TMLELLNHL	TMLELLNQL
IVLEVFEGR	SVLEVFEGR
SYIQQLVQI	SYIQRLVQI
SILEHPPSI	SILEDPPSI
ELSDILIYL	ELSDVLIYL
RRYQKLTEL	RRYQKSTEL
GRSEGTSTK	GRFEGTSTK
VYSIRLAFL	VYSIRLAYL
LPNFRFVVF	LPNFGFVVF
HLLSESPML	HLLNESPML
NLDNLIQTV	NLDNPIQTV
KTASFDSRF	KTAPFDSRF
VMDSLLVQY	VLDSLLVQY
LRHLNFFTK	LRYLNFFTK
VIWKVLNAV	VIWEVLNAV
KMTDIEYRL	KMADIEYRL
YLDWTIKRV	YLDWTIERV
RMFSTPPSL	RMFPTPPSL
ALYGHPLLL	ALYGQPLLL
LPQEVFEKY	LPQEAFEKY
ATFPEFLRY	VTFPEFLRY
GLYPNLIQA	GLYPNLIQV
HMYVGNISK	HVYVGNISK
YYFCYPLFV	YYFSYPLFV
CSGPFGQIF	RSGPFGQIF
KLIDFGYGA	KLIDFGSGA
ALYPHLPAH	ALYPHFPAH
KVADLVDFL	KVADLVGFL
TLISELAQA	TLISELVQA
KLWSESFDV	KLWSETFDV
STMALLVQL	SMMALLVQL
SSGAHTSYY	SSDAHTSYY
RVMEFFFTV	RVMELFFTV
LADQVFAYY	LADQIFAYY
SPWVDNTAL	SPWADNTAL
VYSTPTHFF	VYSTPTPFF
AYVGNRPRI	AYVGNLPRI
FVNHIFERI	FVNDIFERI
NATPIKLIW	KATPIKLIW
YLDNGVVCV	YLDNGVVFV
TVAPFNSTV	TVAPFNPTV
AEEDLYLHF	AEGDLYLHF
FLSTMNVGL	FLSTINVGL
LQIRGRECF	LQIRGRERF
LLIHLTSFL	LLIDLTSFL
RLYNPILWR	RLYKPILWR
YLLEFNTTV	SLLEFNTTV
HYSFYIVTF	HYSFYIETF
HIFNPHLNK	RIFNPHLNK
ILLQGHLYL	ILLQGRLYL
HSTLLALRY	HSALLALRY
CLLESVQKL	SLLESVQKL
VYEAILHQI	VYEEILHQI
ELFSSPPVV	ELFSSPPAV
YLPKDFIRV	YLPEDFIRV
RRSWLSYSY	SRSWLSYSY
VYAKYWIYM	VYAKYWIYV
KYQYILNEI	KYQDILNEI
LLAELLIHL	LLAELLTHL
VLFHNLPSI	VLFHNLPSL
FINILVHSV	FINIVVHSV
FLIRESKTL	FLIRESETL
KIADFGWSM	KIADFGWSV
ALWSLLVFL	ALSSLLVFL
VYTAVDEMF	VYTVVDEMF
KMVEDVISV	KMVEDLISV
KLGEVVTTI	KLGEIVTTI
MIIGEIFEL	MLIGEIFEL
YINKDTIQV	YIYKDTIQV
VLLWEIYSL	VLMWEIYSL
ALSGMAVRL	ALSGLAVRL
ILYEAYVMA	ILDEAYVMA
RLKEEINEV	RLQEEINEV
FLPHKFPSL	FLPRKFPSL
RRKWRCWHL	RRKWRRWHL
QILDGMNYL	QILDGVNYL
ALINNTVEI	ALINNIVEI
YQDLLKLQY	YQDLLQLQY
NMIANVLYL	NLIANVLYL
LLAEPVSGI	LLAEPVPGI
VLLSEILRL	VLLSEILHL
FLATPLLDY	FPATPLLDY
YLLENSRVI	YLLEKSRVI
TLRVFVESV	ALRVFVESV
RYIWATVTI	RYLWATVTI
ILLDWLLYL	ILLDRLLYL
ILKEAHIEL	MLKEAHIEL
LPFQPHVPY	SPFQPHVPY
EVSEIINGL	EVSEIIDGL
KYVDKIYSI	KYADKIYSI
RLFPGLTIK	RLFPGLAIK
RMPEAAPAV	RMPEAAPPV
VLDNVKINL	VLDNVKMNL
FFMERSWYV	FFMERSWSV
FLLENLSFL	FLLGNLSFL
VLYSKSVEV	VLDSKSVEV
WLLEKEDAV	WLSEKEDAV
ALLGTIEKV	ALLGKIEKV
LLPQKIIYL	FLPQKIIYL
ILDRLIGIY	ISDRLIGIY
FLTDREVQL	FLTDREVRL
HIMKKTSLY	RIMKKTSLY
FPDQPHPEI	VPDQPHPEI
VMLDVPKRL	VMLDVPIRL
NYKSIFQQI	NYKSIFLQI
GLYGAIFCL	GLYGAIFRL
SYLQFLLLF	SYLQSLLLF
KLNPQQFDV	KLNPQQFEV
LLWWLQPHL	LLWWLQPRL
SLHGFTIQV	SLDGFTIQV
TLSDRLWGL	TLSERLWGL
KLTGMVFRV	KLTGMAFRV
YLNYDDTRY	YLDYDDTRY
LAIPFTIKK	LVIPFTIKK
LIRKLPFRR	LIRKLPFQR
YVLEGLKSA	YVLEGLKSV
TLYSGVHKK	ALYSGVHKK
WLMKNMGPL	WLMKNMDPL
ALWPQILQK	ALWPQIIQK
ALGPLVALI	VLGPLVALI
AIQDKRFQV	AIQDKLFQV
YTKVVHYQK	YTKVVHYRK
KLNICPLLR	KLNIRPLLR
NVFKEITTM	NAFKEITTM
YYMFIPSKF	YYIFIPSKF
VLMDLKVLL	VLMDLKALL
LLLAEPQLK	LLLAEPPLK
LLFDRPMHI	LLFDRPMHV
NVADVVIRF	NVADVVIKF
VYSPHMLNL	VYSPHVLNL
LLMLDVAPL	LLLLDVAPL
WLFTKVKPL	RLFTKVKPL
YLADTVHKL	YLADTVQKL
KVLDILWEL	KVLDVLWEL
TAMDGVYAL	TAMDVVYAL
YLEPYLKDV	YLEPYLKEV
IMFTAILKK	SMFTAILKK
TYSHSFFHF	TYSYSFFHF
HLDMLHHLY	HLDMLRHLY
YILKIVSTV	YILKIVPTV
TYMNDLYQL	TYMKDLYQL
VFLRAINRF	VFLRAINKF
TLSDPRVYL	TLSDLRVYL
AELGGLPKY	AELGGLLKY
FPDFATVIL	FPVFATVIL
HAVDFLDAF	HPVDFLDAF
FVDGFRASY	SVDGFRASY
FAIPMIHVV	FAIPMIHAV
LAEEIMLHY	LAEEITLHY
ILFGGYVVK	ILFGGYVAK
YLLLFSKSI	YLLPFSKSI
VLFTGVQEV	VLFTGVKEV
ALTSVVDTL	ALTSVVVTL
LLLDRLVSV	LLQDRLVSV
QMFQCFITV	QMFQYFITV
NMMELFIRL	KMMELFIRL
FLHLTLIIL	FLHLTLIVL
CVYVYKVLK	SVYVYKVLK
SMMNRMFAL	SMMDRMFAL
SRNPHGFYL	SRNPRGFYL
KLNDVWKEL	KLSDVWKEL
LTHRLASLY	LTDRLASLY
RYLMENTLF	RYLMENTFF
LPQTALVSF	FPQTALVSF
GENLPSLTY	GENLPPLTY
KTITDTYLL	KTMTDTYLL
NTAINFVLY	NTAINFFLY
TPAEVSIVA	TPAEVSIVV
FLHAADVVL	FLHAVDVVL
GLIDKVNKL	GLIDKVNEL
YLFERTLNL	YLFERTFNL
RETFLQEVW	REAFLQEVW
GMEFTTILY	GTEFTTILY
VITQTVVEV	VITETVVEV
SILPIPWAY	SILPISWAY
FLIVLSIAL	FLIVLSVAL
LILPHISTA	FILPHISTA
ALQALVVTV	ALQALVVTL
MLNEILLQL	MLDEILLQL
YLTAVILEL	YLTAEILEL
RMVQILTSV	RMVHILTSV
LLAEVMENL	LLAEVIENL
CVFENIVAV	RVFENIVAV
TAKAVLADW	AAKAVLADW
ATFIKALFK	ATFIKAMFK
GLATDVHTV	GLATDVQTV
AMLLSITNV	AMLPSITNV
TLLDQMPSL	KLLDQMPSL
KLLPSVTKL	KLLPSVTEL
FLDDFESNY	FLDDFESKY
FPFKPPGIY	FPFKPPSIY
RLLQETELL	RLLQETELV
LLSDKELTV	LLSDKDLTV
VLNLVIVNK	VLNLVIVKK
RVLAMAIYK	RVRAMAIYK
KLVMEILKL	KLVMEIIKL
VLAGYVVEL	VLAGYGVEL
SRNAQTFRF	SRNAQTFGF
LPDTLNVTY	LPDTLKVTY
VTWIHSVTR	VTWIHPVTR
FLVVRVQQV	FLAVRVQQV
KSCLSISGW	KSRLSISGW
VFYPYLQYF	VFYPYPQYF
KLDQVIIHL	KLDQVIIHV
IVLEYVIKV	KVLEYVIKV
SYSDLILFF	SYSDLVLFF
YLTDLQVLL	YLTDLQVSL
NLFNTYPAL	NLFNRYPAL
SILEALPQV	SILEAVPQV
LMVDHVTKV	LMVDHVTEV
SLIEKMWQT	SLIEKLWQT
MLSPFISSM	MLSPFISSV
ILVDWLIQV	ILVDWLVQV
VLNPTPMKR	VLNPTPIKR
ALSHHHIYL	ALSDHHIYL
FYINEQYQF	FYINGQYQF
KLSEIPLIL	KLSEIPLTL
IVFSPVAPK	IIFSPVAPK
KVLEFWAKV	KVLEFLAKV
SYTDQMFLL	SYADQMFLL
VLHSFTDVI	VLHSFTDAI
MLDPLEAHL	MLDPLEVHL
AYSAQIALF	AYSAKIALF
STIDPLIYA	SIIDPLIYA
RLLHFDTEL	RLLNFDTEL
GLYDWMEHL	GLYDGMEHL
FLFFKFIEL	FLFSKFIEL
YLLHERLNL	YLLHEKLNL
KLAERKVSV	KLAESKVSV
QIAVITIFK	QIAVIAIFK
GLIDHQMYL	GLIDHQTYL
KLKDVLPQV	KLKDVLLQV
KLLGQSIQL	KLWGQSIQL
FLSSFNMIL	FLSPFNMIL
GLSKTILAV	GLSETILAV
LYSIHDIFF	LYGIHDIFF
VLIETLITL	VLIETLVTL
NYAENILTF	NYAENILTL
AVLPFVLNK	AVLPSVLNK
FIWSVFWLI	FLWSVFWLI
VFIATFLRY	VFVATFLRY
MLQDSINVV	MLQDSIHVV
LLPEGSPAI	LLPEGPPAI
FLPPVVVTV	FLPQVVVTV
ESIHMTLNV	ESIHVTLNV
YYSPIKMVF	YYSLIKMVF
SLIGNLNLA	SLIGNLHLA
LVIDAIHEV	LVIDVIHEV
HRIEISFKF	HRIEIPFKF
AVMEQIPVI	AVMEQIPEI
ALNVSISVK	ALNVPISVK
PLVDASWEL	SLVDASWEL
SVLGKIWNL	SVLGKIWKL
QLYQGINQL	RLYQGINQL
HYRAPELIF	YYRAPELIF
CEFKLSKVW	REFKLSKVW
ILLERFLAV	ILPERFLAV
KLDEEGLNY	KLDEQGLNY
SEDGTVCIW	SEDGTVRIW
SLQDIVYKL	TLQDIVYKL
LFQRTACVF	LFQRTAWVF
GLDLNAPSV	GLDRNAPSV
SLISELQHA	SLLSELQHA
YMYSGLFCV	YTYSGLFCV
YPVYLGARL	YPAYLGARL
YLPGANLNL	YLSGANLNL
AQFEHTLRV	AQFEHTLLV
FLDHVMCTI	FLDHVMYTI
RLGNLALVK	RLSNLALVK
STYPNTYIF	TTYPNTYIF
LLNLIQTKV	LLDLIQTKV
HYASINTHL	RYASINTHL
GLPKLVIQL	GLPELVIQL
AQFVYYFRV	AQFGYYFRV
FFCWGPFFL	FLCWGPFFL
RLLDNEIKI	RLLDSEIKI
GLLGTFVQL	GLLGTLVQL
STVAILNSV	STIAILNSV
QEAFILCLF	QEAFILRLF
TTFPHPVTV	TTFPRPVTV
KLLEYIKEI	KLLEYIEEI
LPVRLFLII	LPLRLFLII
LLTDIVVFL	LLTDILVFL
VMGALVALV	VMGTLVALV
VLVQVFPSL	VLVQVSPSL
GLAPHLEHI	GLAPHLEQI
KYMYVQFDF	KYMDVQFDF
FMSPWPPAV	FLSPWPPAV
VYTLKVRTI	VYALKVRTI
KYMQKSSEL	KYMQKSLEL
KYSNIRFQF	NYSNIRFQF
DAYELFHVI	DAHELFHVI
SSDANPARY	SSDANPVRY
AVFLGLVRK	AVFLGLARK
LTEIQGSVY	LTEIKGSVY
KIIDFIYTV	KIIDFIYTA
KLTKDFSVL	KLTKDFSAL
LRMPEVPGL	RRMPEVPGL
WEFSEPSFI	SEFSEPSFI
HLCDAFVSV	HLFDAFVSV
RLVQGSIFK	RLVQGSILK
RMFDGKFAV	RMFDGKFVV
WILSGVVTK	RILSGVVTK
KVLGVLLFV	KVLGALLFV
HWINLTFGY	HWIDLTFGY
FLDQHGRNL	FLDQHGHNL
SLNELWVLL	SLNELRVLL
IPTPSLPSY	IPTPPLPSY
ITTVVVQIF	ITTVVVQTF
HAFVELLEF	HAFVELHEF
NLDFLDLSY	NLDFLDLGY
VLDYLRQSY	VSDYLRQSY
VTVGIMIGV	ATVGIMIGV
VLADHVWTL	VLADQVWTL
LVLMVVLYV	LVLMAVLYV
GYPEAALHF	GYPEVALHF
SYLGSIHFF	SYLDSIHFF
YLSSIITTI	YLSSVITTI
AYIERMNHI	AYIERMNYI
LYEPVWHAW	LYEPVWHVW
ILNVTVVYL	ILDVTVVYL
KLFGMIINI	KLFGMIITI
AYPHKLMTF	AYPHNLMTF
EVLNVWTHL	EVVNVWTHL
RILDLETQL	KILDLETQL
IINFSLLFV	IINFSLLLV
SITPIVIFA	SIAPIVIFA
NLANRIPAA	NLASRIPAA
ALPALAMSK	ALPALVMSK
AEFKDAFQL	AEFKEAFQL
RMFPGEVTL	RMFPGEVAL
LLHDGVPVV	LLHDGIPVV
HTFCNELRV	HTFYNELRV
FLDTLKALV	FLDTLKVLV
TLVNFPLHL	TLVDFPLHL
GSWSFIINR	GSRSFIINR
EYPLNLYLL	KYPLNLYLL
GRWFGGPQI	GRWFGGRQI
SLLTSISEV	SLLTAISEV
ALLSGLREV	ALLSGLREA
SLIDTTTAA	SLIDKTTAA
TLLAYTLGV	ALLAYTLGV
SLLDKSLGL	SLLEKSLGL
VYFSAAHVL	VYFSAAHAL
ALWNEIERL	TLWNEIERL
QEMPWNVRI	QEMPWNVRM
SLFAQTYGL	NLFAQTYGL
IYGPNVITI	IYGPNVISI
SPSSSRTDL	SPASSRTDL
ASKEPLYVR	ASKEPFYVR
SPNAKIHIL	SPNAEIHIL
SLIRIAPVV	SLIRIVPVV
LLAEKLEQL	LLAEKVEQL
NVIWDAVTY	NVIRDAVTY
TLFVIVPAL	TLFVIVPVL
ASEYDQIQY	ASEYDQIRY
FPFDQQFSI	FPFDQQFNI
ATVSIMIGV	ATVGIMIGV
IPWDDLITL	IPWDDLIAL
ELMESRMII	ELMESRMRI
QLLGLIQRM	QLLGLIQRV
RLIDFAIQL	GLIDFAIQL
SYLTMHHRI	SYLTIHHRI
ETSHYVDFV	ETSHYVAFV
SLIAKIATA	SLIAKVATA
SYTHIHYLF	SYTHIQYLF
FLYSDEIQI	FLYSDEVQI
FLYDDNQHV	FLYDDNQRV
LVIPITNTY	LAIPITNTY
ILDSVGIVA	ILDSVGIEA
TTAAFIQVV	TTAAFIRVV
FLVDTQHFI	FLFDTQHFI
YLDVSNNRL	YLDLSNNRL
KQASDLISV	KQVSDLISV
AYPTVKFYL	AYPTVKFYF
VSRENTSPK	VLRENTSPK
YVLLPLVAK	SVLLPLVAK
TLNNLDIFL	TLNNLEIFL
SLLPYLPVL	SLLPYLPML
SLSYLVPAL	SLSHLVPAL
FSSPAISRI	FSGPAISRI
SLAQYLINV	SLAQYLINA
TVDEHVCFY	TVDEHVWFY
SLINILVAL	SLIDILVAL
SLSSLVVHL	SLSSLVVQL
NMLPQIFQV	NMLPQIFRV
GLLPDVPFL	GLLPDVPSL
YEWSIKLNW	YEWSVKLNW
KPKGAFKVF	KPKGAFKAF
LPFDLWIPF	LPFDLRIPF
FLFTIINSL	YLFTIINSL
NTQPIPIMY	NTQPIPILY
RVFSWFSVK	RVFPWFSVK
VIMDIVIKV	AIMDIVIKV
NLAEGVERV	NLAEVVERV
YMIAHITSL	YMIAHITGL
ALLQVLSQK	ALLEVLSQK
VLIITLITA	VLITTLITA
IIDDIGHGV	ILDDIGHGV
ILSRVIRSV	ILSGVIRSV
VLVDQEVRL	VLADQEVRL
KMTDVTVTI	KMMDVTVTI
SLCPDLMKI	SLCPDLMEI
HPYPVSNSV	YPYPVSNSV
FLLWAAAEA	FLLWATAEA
FLFNYDCTL	FLFNYDYTL
YYSAVTPDL	YYSAVTPHL
KAFDLRISF	KAFNLRISF
RLWNETMEL	RLWNETVEL
YTSNYFISY	YTSDYFISY
LLGHVLLTL	LLDHVLLTL
YLWSIISKV	SLWSIISKV
MLDVAPLSL	LLDVAPLSL
SVYDFFVRL	SVYDFFVWL
VMPKAVPEV	VMPEAVPEV
KVIDYVLGI	KVIDYVPGI
QADQELLMY	RADQELLMY
VYPTGVHVL	VYPTAVHVL
PYFFHVVTF	PYLFHVVTF
FLETSVPLL	FLETNVPLL
RFMDGYITF	RFMDGHITF
HYIYIENHF	HYIYIENQF
TLDYQVMSL	TLDSQVMSL
LLSVQLPTI	LLSGQLPTI
LYGKYTAEI	FYGKYTAEI
RYIPYPFLV	RYIPHPFLV
FFADLVVGL	FIADLVVGL
FLWSPRALI	FLWGPRALI
TYNQRHSLF	TYNQKHSLF
VLYHVETKV	VLYHVETEV
YLPELVHAV	SLPELVHAV
LLLLHSPAL	LLLQHSPAL
ALVAELEKI	ALLAELEKI
KLFNGTLLK	KLFNGTFLK
KMYKEFLSK	KMYEEFLSK
RLLPLLSLL	RLLPLLALL
YLHPDITRL	YLYPDITRL
ALALAPAEV	ALAPAPAEV
DYFLWTEKF	NYFLWTEKF
FLLFINHCL	FLLFINHRL
QYFLPPYTF	RYFLPPYTF
RFIGTTANF	RFIGATANF
VLFDLGFAI	VLFGLGFAI
QSWVHLLSR	QSWVPLLSR
HLASTLVQV	RLASTLVQV
ITDQGIKFY	ITDQGIEFY
TESQQICYF	TESQQIRYF
TVFKHTFHV	TVFEHTFHV
LPHDADLAY	LPHDPDLAY
RLDDNIQTV	RLDDNIRTV
SYTYLSVGF	SYTYLSLGF
QLINIIHTA	QLIDIIHTA
CIISAVVGI	SIISAVVGI
ILMHHSPQV	ILMHHPPQV
YVDSQFLTY	YVDPQFLTY
TLALWLVSK	TLALWPVSK
SMYDKVLMI	SMYDKVLML
FPKGLFYEF	FPEGLFYEF
ETRHVTMVV	ETSHVTMVV
ALYTSRLYL	ALYASRLYL
YLYQRELLL	YLDQRELLL
SLLEPLVYL	SLLEPFVYL
ILLVPAFNV	ILPVPAFNV
EEGPDVHRW	EEGPDVLRW
FIDASRLLY	FIDASRLVY
GLLANIFEL	GLLAKIFEL
LYSPPPHTL	LYPPPPHTL
NEINIAPRI	SEINIAPRI
IASNIRAAY	IASNIWAAY
SLLDTIIGA	SLLDKIIGA
ALPSLLHLL	ALQSLLHLL
VISPPTVSK	VISPPTVPK
ILSAVETRL	ILAAVETRL
SLSTVVVVL	SLSTVFVVL
ILHDTVVFL	ILHDAVVFL
SLIEQNTAL	SLIEQTTAL
TLSNVWIFL	TLSNLWIFL
ALNKMFFQL	ALNKMFCQL
CRTGIPISM	RRTGIPISM
FLFELPSCL	FLFELPSRL
TLVDEVYRI	TLVDEVFRI
HEAVLYYVL	HEALLYYVL
AVYLHALVR	AVYLRALVR
ILIYKLLGA	ILISKLLGA
TAMGVVYAL	TAMDVVYAL
SLSGISMQK	SLSGISLQK
LLLEAVWHI	LLLEAVWHL
WYIIKKDFF	RYIIKKDFF
FIDASHLVY	FIDASRLVY
IVFMPIIGK	IVFMPVIGK
FMMPQIVNV	FMMPRIVNV
GVLSNIQAV	GVLPNIQAV
VSDFCLSRY	VSDFGLSRY
HLYDHTVKL	HLYDYTVKL
NYISYLTKL	NYIPYLTKL
KIYEGQVEA	KIYEGQVEV
ILSESAPSL	ILSELAPSL
KSDPFFVFY	KSDPFLVFY
FINVTSVHL	FLNVTSVHL
YLDTINRSA	YLDTINRSV
TVFYLIENY	TAFYLIENY
TASKVIVAM	TASKVIVAV
SELEKIFGW	SELEKTFGW
LLWVDLIWL	LLWGDLIWL
RTASLLLSY	RTAPLLLSY
SLSSLELLL	SLSSLELFL
YLEENVYQL	YLEEDVYQL
WLMGSILGV	RLMGSILGV
TLLAGIAGV	TLLAGITGV
QTVDILENV	QTVDIPENV
FLFAVGFNL	FLFAVGFYL
ILATEVVTV	LLATEVVTV
KILQELSSV	KILQELPSV
SLLMSIHSI	SLLMSIHNI
FVDGLAFKV	FVDGLTFKV
TRLPWAGQL	ARLPWAGQL
ELADYLYNI	ELAEYLYNI
YYMELMKLL	YYMELTKLL
ALFPGRITV	ALFPERITV
SLDSTLHAI	SLDSTLHAV
LLLALIIAL	LLLAHIIAL
LLNEDLEQV	LLNEDLEKV
TLYDIRAAL	TLYDIRAEL
ILVPKPQGV	ILGPKPQGV
FLATVIHTL	FLVTVIHTL
GLIDENPVL	GLIDENPGL
YLQPIQRTI	YLKPIQRTI
VYSADVYRL	VYSAGVYRL
KLIDRTEYL	KLIDRTESL
VEFHEPESW	VEFHEPETW
RSNFFTSFY	RSDFFTSFY
RLLTVFPSL	RLLTVLPSL
SLFERLVGL	SLFERLVVL
VLLRTIHEL	VLLSTIHEL
AFSPAIQMF	AYSPAIQMF
HLVEIQYEL	RLVEIQYEL
NYATALETF	NYAAALETF
ALHELLQHV	ALNELLQHV
LPSKPKNPL	LPSKPKSPL
NLGTVILLV	TLGTVILLV
SLGRFELTV	SLGRFEITV
LLVPKPFPL	LLGPKPFPL
LLNVTPLSL	LLDVTPLSL
QLFNGTFVK	QIFNGTFVK
SLLKRLLTY	SLLERLLTY
TLDITSHTV	TLDITPHTV
SLYKFLASV	SLDKFLASV
FPYFFESQI	FPYFFESRI
YPDCIMNTF	YPDRIMNTF
SLHFLIIYV	SLHFLILYV
SILHDVVEA	SILHDVVEV
RINIPKVLR	RVNIPKVLR
FLPSCIIDV	FLPSYIIDV
CLASTLVHL	RLASTLVHL
QTMALPVGR	RTMALPVGR
KMAQMLVEL	KMAEMLVEL
TFQVKFFYI	TFQMKFFYI
RLWVEPVNL	RLWGEPVNL
SLLKYIETL	ALLKYIETL
VLHKELSEV	VLHKELPEV
CISGLFNFY	FISGLFNFY
TIEGGIFEV	TIEDGIFEV
MLSNQPLLK	TLSNQPLLK
SLYGPGTSR	SLYGPGTNR
STDHIAILY	STDHIPILY
YLASLICSV	YLASLIRSV
FLIAALDML	FLIAALDVL
TPSPPKVVY	TPSPPEVVY
LLVRNSFEV	LLGRNSFEV
RLLDALELL	RLLDALEFL
LFVPRSTEF	LFMPRSTEF
WLVDHVYVI	WLVDHVYAI
HLTYLIVYL	HLTYLNVYL
LLSGTSPFL	LLSGASPFL
AAMDVVYAL	TAMDVVYAL
KYMDINFDV	KYMDINFDF
EEIEIILRY	EEIEILLRY
LIWPMLIHI	FIWPMLIHI
ILHDQLYYL	ILHDRLYYL
ILIDWLVPV	ILIDWLVQV
RLFYDISKK	RLFYDISEK
RPAISMDSL	RPAKSMDSL
ETYPDVVKI	ETYPDAVKI
FLDGKELTL	FLDGNELTL
VLEDLKVTV	VLEDLEVTV
FVRLHYYSV	FVWLHYYSV
IMIGVLVVV	IMIGVLVGV
SLFDQQLAL	GLFDQQLAL
KYPKNFFLL	KYPENFFLL
KLDWHQFNL	KLDWHRFNL
RVRFNLMKK	RVRFNLMEK
ALDIMILMV	ALDIMIPMV
IIQEKLQEI	ILQEKLQEI
ATVDTVIIY	ATADTVIIY
AEDELFNIY	AEDELFNRY
NILIILTGR	TILIILTGR
YYLNNLERI	YYLNDLERI
VLYENKDAV	VLYENKVAV
ILDTKVEKV	ILDKKVEKV
FLIKQVVEV	LLIKQVVEV
HLIEPLVNA	HLIEPLANA
SYLWTINNF	SYMWTINNF
IEILSQQLF	NEILSQQLF
LLADLLHNI	LLADLLHNV
LPANILVEF	LPAKILVEF
TLAGDIHIV	TLAGDVHIV
RLDSYVCSL	RLDSYVRSL
KLFNKFIQL	KLFNEFIQL
SIFPHVTTK	SIFPYVTTK
YFLSITPHY	YFLPITPHY
FLASILQEL	FLASILEEL
SLLEHLSQV	SLLEHLSHV
QLFNFDMNV	QLFKFDMNV
FVNDIFQRI	FVNDIFERI
RIKPHWVVK	RIKPPWVVK
FLQPSGYHV	FLQPGGYHV
FLNKMKIVV	FLNKMKIMV
AMNHEVSSL	AMNREVSSL
SVMTQVFHV	SVITQVFHV
DLAPVNAFI	DLAPINAFI
LQLGKEFQL	LQLDKEFQL
NLYPFVKAV	NLYPFVKTV
GLLEGVVEV	GLLEGLVEV
EFYFAKLYY	GFYFAKLYY
KLYEEIDQV	KLYEEINQV
TLDAKIEKV	TLDEKIEKV
VRYEGSYVL	VRYEGSYAL
AVNFPFIVK	AVNFPFLVK
ALQGDLTKA	ALLGDLTKA
NEAVIAQFY	SEAVIAQFY
IFNPFPASK	IINPFPASK
FPAKVMAHW	FPAKVTAHW
LSDLGHLSY	LSDLGRLSY
KYNETFKFI	KYNETFQFI
YIFGTCLGL	YIFATCLGL
ILDDSHLLA	ILDDSHLLV
SLIQQLMSV	SLIQRLMSV
TELIISEVF	AELIISEVF
TYFPYFLSR	TYFPSFLSR
ILAAPEILK	ILAAPGILK
RLHNVLMEL	RLHDVLMEL
FYITSHTQF	FYITSRTQF
ALGNLFQSI	ALGDLFQSI
FVTRMIPKV	FVARMIPKV
NIFGIPEFV	NIFGTPEFV
NVDTILEEY	NVDAILEEY
KTTLKRLFR	KTILKRLFR
LLLDTVQHL	LLSDTVQHL
LPQPPICAI	LPQPPICTI
HLSVVFVTV	HLSVVSVTV
FPIEYYDIW	FPIEYHDIW
YLYDLNHML	YLYDLNHTL
QLAQFVYEV	QLAQFVHEV
ALYTGDFRL	VLYTGDFRL
YLDEMVKEV	YLDEIVKEV
YLAAMLEYL	YLAAVLEYL
ALAPGVRAL	ALAPGVRAV
KRFWYIKGI	KRFWYIEGI
QMISHIEYI	QMISRIEYI
EERIINEEY	EERVINEEY
FILQTLILV	SILQTLILV
VLASLIICL	VLASLIIRL
SITAVLPKV	SIAAVLPKV
TLASFTDLY	TSASFTDLY
SLSPMYPAA	SLSPIYPAA
LLAETYYQL	LLAETHYQL
TLWMDPYEV	TLWVDPYEV
ALTSHLIEA	ALASHLIEA
VLMDKPDVV	VLMEKPDVV
SSNTLPTEY	STNTLPTEY
YLEDYKFQV	YLEEYKFQV
IVVDTVWAL	ILVDTVWAL
YLLGDLFGV	DLLGDLFGV
ARYLINEGF	ARYLVNEGF
KLTDNLVAL	KLTENLVAL
KLQLPPLGR	KLQPPPLGR
MYPEESLVI	VYPEESLVI
YLSNNVHLV	YLSDNVHLV
KLMNKVVRL	KLMDKVVRL
SLYEMVSQV	SLYEMVSRV
VADLVEALY	AADLVEALY
STAALFLLR	STAAFFLLR
RYQDRLQYF	RYRDRLQYF
ALNQMFCQL	ALNKMFCQL
TAMDVFYAL	TAMDVVYAL
IVLEVFEGR	SVLEVFEGR
RLFVGSISK	RLFVGSIPK
SRAGLQFPI	SRAGLQFPV
VYVAAVQEF	VYVAAVREF
SMSELDIKL	SMAELDIKL
FLFNRLTNG	FLFDRLTNG
SLLSNIIAL	SLLSDIIAL
FLDETVHFA	FLDENVHFA
YLNDRVNEL	YLNDRVDEL
ILDIAGFKI	ILDIAGFEI
SLASVLVRL	SLASVFVRL
YLQEKLNAL	YLQEKLHAL
FLLEIRQSL	FLLEIRQTL
FMATIADGL	FMATIAEGL
AYNVLFHQW	AYDVLFHQW
SVISFPLLK	SVISSPLLK
SYTTLFPQL	SYTALFPQL
EAIQLIARM	EAIQLIARI
YYIIYRSVF	YYIIYRNVF
ATFTAMGLK	ATFTVMGLK
QMLELITIL	QMLELITRL
YLVTSMAKA	YLVTSIAKA
VLWPESISM	VLWPESISV
KTLEGECSV	KTLEGEFSV
VYQHMFTRI	VYQHLFTRI
GLIEKNIKL	GLIEKNIEL
MLANNIARL	MLANDIARL
FQLAKTCPV	CQLAKTCPV
RMFPNASYL	RMFPNAPYL
EEASIYSQW	EEASIYSRW
FILPYNHKA	FILPYIHKA
HYFPKAPEF	QYFPKAPEF
KLLKYLPEL	KLLKDLPEL
YFSLGKYYW	YFSSGKYYW
SLWEQPAEA	SLWGQPAEA
LLYHCWIAV	LLYHYWIAV
TLQKFLERI	TLQEFLERI
YQGRYGFRL	YQGSYGFRL
LLLEKSRVV	FLLEKSRVV
HLLERVNQV	HLLERVDQV
YALTVVCLL	YALTVVWLL
SYPGSSYSF	SYPGSSYIF
LLADVDTFV	LLADVETFV
IVDGFNVLY	VVDGFNVLY
SYMGRFDLL	SYMGHFDLL
REELRQITW	REELQQITW
ALLDIIVSV	ALLDRIVSV
VYLEKFMNF	VYLEKFMTF
QYPVIIYLI	QYPVIIHLI
CTYGVRAAW	GTYGVRAAW
GEVKGHPVW	GEVEGHPVW
GLFQGKTLL	GLFQGKTPL
LMDHIIPEV	LMDHTIPEV
RYMSINIHL	RYMSINTHL
ALNALIMAY	ALNALILAY
LLLNEMPSV	LLLNELPSV
GLSEQIQEL	GLSEQIREL
ILDEVIYKV	ILDEAIYKV
VLGQFVVLK	VLGQFLVLK
KISVIMETV	KISVIVETV
KVTGAATPK	KVAGAATPK
HLAKVTADV	HLAKVTAEV
FSFSGLLRK	SSFSGLLRK
MQYVFTFYV	MQDVFTFYV
HERTFILEY	HERTFLLEY
HTWVAELVF	RTWVAELVF
KRFGKAYNV	KRFGKAYNL
QRLSVNYVK	KRLSVNYVK
KLLAVIHKL	KLLAVIHEL
SYIQESATF	AYIQESATF
RYVAQTSLL	RYVALTSLL
NLPTRIPIV	NLPTGIPIV
FILSLIFEY	FILSLILEY
HLLDQVEQI	QLLDQVEQI
CQLAKTYPV	CQLAKTCPV
SEELLSLTY	SEELLSLKY
KPWERSPIL	KPWEKSPIL
VYVMVNAKF	LYVMVNAKF
TLLERGFSL	TLLERAFSL
RYMDQVLQL	RYVDQVLQL
VYLPRVLGI	VYLPRVLDI
MITDVVPEI	MITDVVPEV
KLMAPDISM	KLMAPDISL
SMDELFVLI	RMDELFVLI
HLIHAPLEV	HLIHAPPEV
YAYEKPYVV	YAYEKPHVV
SAVFIISYV	SAAFIISYV
ILKEITPLL	ILKEISPLL
VLLEMDARL	ALLEMDARL
FLNNEVWNL	FLNDEVWNL
TENDVRVMF	TENDIRVMF
RFMNHMQSL	RYMNHMQSL
RYLKGPELL	RYFKGPELL
ILIKRQQQK	ILIKRRQQK
ALYEKDIQL	VLYEKDIQL
YLSGTNLNL	YLSGANLNL
FVFQFIPYM	FLFQFIPYM
ALQDFLLSL	ALQDFLLSV
SLASIIFLL	SLASVIFLL
ALTPGVVTL	ALTPVVVTL
GLKEGISAL	GLKEGIPAL
YILEKSRAI	YLLEKSRAI
GLYNVVYGI	GLHNVVYGI
RYTSAIDVW	RYTPAIDVW
SLYFVSPSL	SLSFVSPSL
RYSGSQVLF	RYSGNQVLF
RILDYVVNL	RILDYVINL
KLTVVLEDV	KLTVVLEAV
FMSEYMIEL	FMSEYLIEL
YYEHIVTTL	YYQHIVTTL
VADLHIYLY	VADLHLYLY
CIAKITEGV	YIAKITEGV
AEFNLRRDW	AEFNLRHDW
AVANIINSV	AVANIVNSV
TILGHEFVL	TLLGHEFVL
KILEYVVGV	KILEDVVGV
KLIGQVHKV	KLIGQVHEV
MYPCIFHVL	MYPYIFHVL
STNFKRIYR	STNFKLIYR
AEAIHLPQV	AEAIHSPQV
NMLEAVHRI	NMLEAVHTI
YLINRSWEW	YFINRSWEW
IVDEFAMCY	IVDEFAMRY
SLLNNLLTI	SLLDNLLTI
SLYSQVHHI	SLYSQVHQI
ILDRFLATV	LLDRFLATV
LLADKIYKI	LLAEKIYKI
NLFEWHFMV	NLFEWHFTV
AYAILTHGI	VYAILTHGI
RYLDSHQLF	RYPDSHQLF
AMDVYKNFY	AMDVYKNLY
FLAMLVLMV	FLAMLVLMA
SYLDNFLHI	SYPDNFLHI
SPASFLSSW	SPASFFSSW
SLATSFPRL	SLATSLPRL
GLMKTAYEL	GLMKKAYEL
AMIKLVERL	AMIELVERL
HLVPDVPTV	HLVPEVPTV
ATADVEWCW	ATADVEWRW
GLIDFGIYK	GLINFGIYK
KLLSETVTI	KLLPETVTI
DMDDYIFTY	YMDDYIFTY
YAINLPVSV	YAIDLPVSV
YLSIVDVYL	YLSNVDVYL
TISPIVLYF	TISPIILYF
FLIDNGASL	FLIDNGVSL
RLLEYSKGV	RLLEDSKGV
YQLEDIQRV	YQLEEIQRV
TVTDMVRFI	TVTDVVRFI
ALIQRLEAL	ALLQRLEAL
ATVLFSFLY	ATALFSFLY
YYLNPIELF	YYLNLIELF
IIYPKTLFL	ILYPKTLFL
ILFGHKNRV	ILFGHENRV
RFSFPNLFK	RLSFPNLFK
IEHGIIINW	IEHGIITNW
KLVDRPQEL	KLFDRPQEL
HYLDEINLL	RYLDEINLL
RLAQLITYV	RLAQHITYV
KYLTELTLI	KYLMELTLI
CLEEGIRFL	RLEEGIRFL
TYENLVHVW	TYENLIHVW
RLLDYMVNI	RLLDYVVNI
AMFIGHTTA	AMFIGHATA
VLDSVDVRI	VLDSVDVRL
ALDKATMLL	ALDKATVLL
LYTENFEEF	LYTEKFEEF
SPASLFSSW	SPASFFSSW
EYIGYSFKF	EYTGYSFKF
FVTCLGLSY	LVTCLGLSY
LLVRNSFEV	LLGRNSFEV
LMLPGLETV	LLLPGLETV
TLDEYTTCV	TLDEYTTRV
NYIMKMHNF	NYIMKIHNF
IYTWIQDHF	IYTWIEDHF
YLAKHIQNI	YLAKHIENI
AYLSEMLRF	AYLSGMLRF
TLTDITKGV	ILTDITKGV
FVFRFPVSV	FVFSFPVSV
YLCLKLNQV	YLWLKLNQV
SLQEKIAFL	SLQEEIAFL
HLAEALHQV	HLAEALHQA
KLVAAISEV	KLAAAISEV
QERDDILKF	QELDDILKF
VYMIIVKCW	VYMIMVKCW
VLFTITKTI	VLFTITKTV
KSESVQEQW	KSGSVQEQW
YLFPGISEL	YLFPGIPEL
FLDNERLEV	FLDNERHEV
ILGGSVLYL	ILGGSVLHL
ILSTHVATA	ILSAHVATA
MTDPIHILV	MTDPIRILV
ALLTVVSRV	ALLTVVSQV
GLDIPMVQV	GLDIPTVQV
RMLLHAPGV	RMLPHAPGV
RLFESSQYI	RLFESSQYL
VLTESPPNL	VLTESPPSL
HLLTSLRAK	RLLTSLRAK
KYMKHTRLF	EYMKHTRLF
AEQYLVQTL	AEQDLVQTL
QLWFREFLL	QLWFREFFL
WIDPFEVYY	WIDPFEVSY
MLDEPTNHL	ILDEPTNHL
VLLDRIASV	LLLDRIASV
FLQDHPWLL	LLQDHPWLL
RLFIGRIPK	RLFIGGIPK
FLAGFLLSV	SLAGFLLSV
FTEKDVKFY	FTEEDVKFY
NILDFVVVI	NILDFVVVV
LYPFTNYTF	LYPLTNYTF
KLLHIRSYL	KLLDIRSYL
IVMEHVVYL	IVMEHVVFL
NIGQVFLLK	SIGQVFLLK
IYIAGHPTF	IYIAGHPAF
SMHQIVLYL	SMHQILLYL
RLANIVERV	HLANIVERV
AMFALPAKK	AMFALPAEK
LLMQHIFKL	LLMEHIFKL
GLFSGKPEV	SLFSGKPEV
KLLDKAFSI	KLLEKAFSI
YQVEQLYSV	YQVGQLYSV
SYANYFICL	SYANYFIRL
NPVQAISEF	NPVQALSEF
KVAELVYFL	KVAELVHFL
SLAEGLQTV	SLAEGLRTV
RLFSPLRQR	RLFPPLRQR
LVFATMISK	LVFATMITK
YMLVLEARL	YMLGLEARL
LYIPIFSTV	LYIPIFSTF
SLMSHVIEL	SLMSHAIEL
YLQNWSNVL	YLQNWSHVL
ALKSLIPSL	ALQSLIPSL
FMLIPTLII	FMIIPTLII
TLLYFLVEI	TLLHFLVEI
VIFDLSTTV	VIFDLPTTV
KLYTVLREV	KLYTGLREV
IYSWFTLTF	IYSWFTRTF
DTFGKIDFL	DTFGKINFL
SLLDGHLVL	SLLDGHFVL
NTAYIQVIV	NTAYIQAIV
FMPKDMLYL	FMLKDMLYL
YLLQRAAEV	YLLQRAVEV
