cancer	wt
AMFWSVPTV	AMFRSVPTS
CLNEYHLFL	CLNEYHLFF
DANSFLQSV	DANPFLQSV
EEEYPGVTA	EEEYPGITA
ETSKQVTRW	ETSEQVTRW
FIMGISILL	FITGISILL
FIWGDAPPT	SIWGDAPPT
FLFLVLLFV	FLFSVLLFV
FLNCNSSRL	SLNCNSSRL
FLYNLLTRV	FLYNPLTRV
FTQEKWYHV	FTQEEWYHV
FVFCALLLV	FVFRALLLV
FVSALCMFL	FVSALRMFL
GRIAFFLKY	GRIAFSLKY
HIVEISTPV	HMVEISTPV
ILNPADPTL	ILDPADPTL
IMAHCILDL	IIAHCILDL
KLILWRGLK	KPILWRGLK
KLKLPIIMK	KLKLPMIMK
KLMNIQQKL	KLMNIQQQL
KMIGNHLWV	EMIGNHLWV
LLSIIFFPA	LLSIISFPA
LLSIVPCTV	LLSIVLCTV
LMLESGYIL	LMLESGYIP
LMSIIIVGV	PMSIIIVGV
LPIQYEPVL	PPIQYEPVL
MLGEQLFPL	MLGERLFPL
MLSSVACSL	VLSSVACSL
QLSCISTYV	QLSCTSTYV
SLLLLSVSV	SLLLLPVSV
SPGPVKLEL	SPGPVKLEP
SVMIMAFSV	SDMIMAFSV
VLLRALPVL	VLLRALPVP
WLTRNFYFV	WLTRNLYFV
WMAPEVILV	WMAPEVILA
YIDERFERY	YIDEQFERY
YMAELTVTL	YMAKLTVTL
YSDNSNDSF	YSDNSNGSF
