Cancer	WT
AEHSLQVAY	AEHSLQVAH
AEPINIQTW	AEPIDIQTW
AFGSAHLFR	AFGSAHLYR
ALIHHNTYL	ALIHHNTHL
ALSPVIPHI	ALSPVIPLI
ALYGFVPVL	ALYGSVPVL
AQQITKTEV	AQQITQTEV
ASNASSAAK	ASNAPSAAK
AVGSYVYSV	AVGSHVYSV
CILGKLFTK	CILGELFTK
CVRVSGQGL	RVRVSGQGL
DANSFLQSV	DANPFLQSV
EHEGSGPEL	EREGSGPEL
ELLVRINRL	ELLFRINRL
ETVSEQSNV	ETVSEESNV
EVLPFFLFF	EALPFFLFF
FAFQEYDSF	FAFQEDDSF
FFYLLDFTF	FFYPLDFTF
FLDEFMEGV	FLDEFMEAV
FLIYLDVSV	FLTYLDVSV
FLLDEAIGL	FLLDEANGL
FLSDHLYLV	FLSDHPYLV
FMPDFDLHL	SMPDFDLHL
FPKKIQMLA	FPKEIQMLA
FRSGLDSYV	FRSRLDSYV
GADGVGKSA	GAGGVGKSA
GLFGDIYLA	GSFGDIYLA
GLLDEDFYA	GPLDEDFYA
GQFLTPNSH	GQFLAPNSH
HDLGRLHSC	HDLGRLHPC
HIAKSLFEV	HIAKSPFEV
HMTEVVRHC	HMTEVVRRC
HSCVMASLR	HPCVMASLR
ILAALFLGL	IWAALFLGL
ILCETCLIV	ILCGTCLIV
ILNAMIAKI	ILNAMITKI
ILTGLNYEV	ILTGLNYEA
KIFSEVTLK	KIFSEVTPK
KLKFVTLVF	ELKFVTLVF
KLSHQLVLL	KLSHQPVLL
KLYEEPLLK	KLYEEPLSK
KPFCVLISL	KPFRVLISL
KTLTSVFQK	ETLTSVFQK
KVDPIGHVY	EVDPIGHVY
LIIPFIHLI	LIIPCIHLI
LLFGMPPCL	LLFGMTPCL
LLQCTQQAV	LLQCTRQAV
LPNEYAFVT	LPDEYAFVT
LSSVSFFLV	LSSVSFFFV
MLFSHGLVK	MLFSRGLVK
NLNCCSVPV	NLNRCSVPV
QQFAVGSYV	QQFAVGSHV
QTNPVTLQY	QTDPVTLQY
RMQYSMECF	RMQYSMEYF
RPHHDQRSL	RPHHDQRSS
RPHVPESAF	GPHVPESAF
RTKVVQTLW	RTEVVQTLW
RVCGPCSTY	RVRGPCSTY
RVSTLRVSL	RVSTLRVSP
SEKLRHMLL	FEKLRHMLL
SPMIVGSPW	SPMIVGSPR
SSYTGFANK	SNYTGFANK
SYLDSGIHF	SYLDSGIHS
SYMIMEIEL	SSMIMEIEL
TEDEHFEFY	TEDEHFEFH
TESPFEQHI	TKSPFEQHI
TLWCSPIKV	TPWCSPIKV
TLWCSPIKV	TPWCSPIKV
TLYSLTLLY	TLYSLTPLY
VESEDIAEL	VESEEIAEL
VTEKLQPTY	VTEKLQLTY
VVGAAGVGK	VVGAGGVGK
VVGACGVGK	VVGAGGVGK
VVGADGVGK	VVGAGGVGK
VVGAVGVGK	VVGAGGVGK
VVPCEPPEV	VVPYEPPEV
YPVIFKSIM	YPVISKSIM
YSMECFQFM	YSMEYFQFM
YTDFHCQYV	YTDFPCQYV
